- Dashboard

- Sales                     = ПРОДАЖИ =
    - Orders                = Заказы
    - Invoices              = Счета-фактуры
    - Shipments             = Отгрузки
    - Credit Memos          = Кредитные авизо
    - Transactions          = Транзакции
    - Recuring Profiles     = Повторяющиеся профили
    - Billing Agreements    = Соглашения о выставлении счетов
    - Terms and conditions  = Положения и условия
    - Tax                   = Налог
    
- Catalog                       = КАТАЛОГ =
    - Manage Products           = Управление продуктами
    - Manage Categories         = Управление категориями
    - Attributes                = Аттрибуты (товаров)
    - URL Rewrite Management    = Управление перезаписью URL
    - Search Terms              = Условия поиска
    - Reviews and Ratings       = Отзывы и рейтинги
    - Tags                      = Теги (метки)
    - Google Sitemap            = Карта сайта Google
    
- Customers             = ПОЛЬЗОВАТЕЛИ =
    - Manage Customers  = Управление пользователями
    - Customer Groups   = Группы пользователей
    - Online Customers  = Пользователи on-line
    
- Promotions                        = АКЦИИ =
    - Catalog Price Rules           = Правила цен каталога
    - Shopping Cart Price Rules     = Правила корзины покупок
    
- Newsletter                        = НОВОСТНЫЙ РАССЫЛКИ =
    - Newsletter Templates          = Шаблоны новостных рассылок
    - Newsletter Queue
    - Newsletter Subscribers
    - Newsletter Problem Reports
    
- CMS                   = ЦМС =
    - Pages             = Страницы
    - Static Blocks     = Статические блоки
    - Widgets           = Виджеты
    - Polls             = Голосования
    
- Reports                   = ОТЧЕТЫ =
    - Sales                 = Продажи
    - Shopping Cart         = Корзина покупок
    - Products              = Продукты
    - Customers             = Пользователи
    - Tags                  = Теги (метки)
    - Reviews               = Отзывы
    - Search Terms          = Условия поиска
    - Refresh Statistics    = Статистика обновлений
    
- System
    - My Account
    - Notifications
    - Tools
    - Web Services
    - Design
    - Import/Export
    - Manage Currency
    - Transactional Emails
    - Custom Variables
    - Permissions
    - Magento Connect
    - Cache Management
    - Index Management
    - Manage Stores
    - Order Statuses
    - Configuration
